111111111111111111111111
1111000C00001000000C0111
1C11000111C0001111000C01
100C011100000110C1100011
1P0011C00C0C000011001111
100011111100C001100C0001
11C00011C0000011C0000101
111001100C00011111000C11
11000000C0000000C000E001
111C00010000C00000110111
111111111111111111111111