11111111111111111111111111111111111
10000000000000000000000000000000001
10111110111110111110111110111110101
10000010100010000010100010000010101
11110110101110111010111011101110101
100101000C000C000000000100000000101
10110111111110111111110111111110101
10000000000000P0000000000000C000101
10111111111110111111110111111110101
10100000000000100000000100000000101
10101110111110111010111010111010101
10000010100000000010100010000000001
11110110101110111010111011101111101
100001000C000C000000000100000000001
10111111111110111111110111111111101
1000000C000000000000C00000000000E01
11111111111111111111111111111111111