111111111111111111111111111111111111111
100000000000000000000000011000000000001
100100000C001100100000C001100100000C001
100C011111001100C011111001100C011111001
100011E000001100100000C0011P0011000C001
100C011111001100C011111001100C011111001
100100000C001100100000C000000100000C001
100100000C001100100000C000000100000C001
100100000C001100100000C000000100000C001
100100000C001100100000C000000100000C001
111111111111111111111111111111111111111