111111
1EC001
1C1101
1P0C01
111111