1111111111111
1C000C000C001
100P011111001
100011E00C001
1111111111111