111111111111111111111111
1C00001111C0001111000C01
100C011000000110C1100001
1P0011C00C0C000011000001
100011111100C001100C0001
10C00011C0000011C0000001
100001100C00011111000C01
1000000C0000000C00000001
100C00000000C000000E0001
111111111111111111111111