111111
1EC001
1C1101
1P0CC1
111111