111111
1EC001
101101
1P0001
111111