111111111111011111111111
100000000000000000000001
100C0E000000000000000001
100P00000000000000000001
111111111111111111111111